******************************************************************
*................................................................*
*........***********..........................***********........*
*........***********..........................***********........*
*........***********..........................***********........*
*........***********..........................***********........*
*................................................................*
*................................................................*
*................................................................*
*................................................................*
*................................................................*
*................................................................*
*................................................................*
*...................**************************...................*
*...................**************************...................*
*...................**************************...................*
*...................**************************...................*
*................................................................*
*................................................................*
******************************************************************