************************************************************
*..........................................................*
*......*..............................................*....*
*......*....................* ........................*....*
*......*************........*........*************....*....*
*...........................*.........................*....*
*...........................*........*************....*....*
*......*************........*..............................*
*..........................................................*
*........*************..........*************..............*
*..........................................................*
*........*************.................*************.......*
*.....*.................*************......................*
*.....*....................................................*
*.....*...............*************......*************.....*
*.....*....................................................*
*.....*.......*************.............*************......*
*..........................................................*
*..........................................................*
************************************************************